WWWWWWWWWWWWWWWWWWWWWWWWWWWWWWWW
WWWWWWWWWWWWWWWWWWWWWWWWWWWWWWWW
WWWWWWWWWWWWWWWWWWWWWWWWWWWWWWWW
WWWGCCCCCCCCCCCWWCCCCCCCCCCCIWWW
WWWCWWWWCWWWWWCWWCWWWWWCWWWWCWWW
WWWCWWWWCWWWWWCWWCWWWWWCWWWWCWWW
WWWCWWWWCWWWWWCWWCWWWWWCWWWWCWWW
WWWCCCCCCCCCCCCCCCCCCCCCCCCCCWWW
WWWCWWWWCWWCWWWWWWWWCWWCWWWWCWWW
WWWCWWWWCWWCWWWWWWWWCWWCWWWWCWWW
WWWCCCCCCWWCCCCWWCCCCWWCCCCCCWWW
WWWWWWWWCWWWWW_WW_WWWWWCWWWWWWWW
WWWWWWWWCWWWWW_WW_WWWWWCWWWWWWWW
WWWWWWWWCWW__________WWCWWWWWWWW
WWWWWWWWCWW_WWWWWWWW_WWCWWWWWWWW
WWWWWWWWCWW_W______W_WWCWWWWWWWW
WT______C___WESIGSEW___C______TW
WWWWWWWWCWW_W______W_WWCWWWWWWWW
WWWWWWWWCWW_WWWWWWWW_WWCWWWWWWWW
WWWWWWWWCWW__________WWCWWWWWWWW
WWWWWWWWCWWWWWWWWWWWWWWCWWWWWWWW
WWWWWWWWCWWWWWWWWWWWWWWCWWWWWWWW
WWWCCCCCCCCCCCCWWCCCCCCCCCCCCWWW
WWWCWWWWCWWWWWCWWCWWWWWCWWWWCWWW
WWWCWWWWCWWWWWCWWCWWWWWCWWWWCWWW
WWWCCCWWCCCCCCC_MCCCCCCCWWCCCWWW
WWWWWCWWCWWCWWWWWWWWCWWCWWCWWWWW
WWWWWCWWCWWCWWWWWWWWCWWCWWCWWWWW
WWWCCCCCCWWCCCCWWCCCCWWCCCCCCWWW
WWWCWWWWWWWWWWCWWCWWWWWWWWWWCWWW
WWWCWWWWWWWWWWCWWCWWWWWWWWWWCWWW
WWWSCCCCCCCCCCCCCCCCCCCCCCCCEWWW
WWWWWWWWWWWWWWWWWWWWWWWWWWWWWWWW
WWWWWWWWWWWWWWWWWWWWWWWWWWWWWWWW
WWWWWWWWWWWWWWWWWWWWWWWWWWWWWWWW
