WWWWWWWWWWWWWWWWWWWWWWWWW
WWWWWWWWWWWWWWWWWWWWWWWWW
WWWWWWWWWWWWWWWWWWWWWWWWW
WWWCCCCCCCCCCCCCCCCCCSWWW
WWWGWWWWWCWWWWCWCWWWWCWWW
WWWCWWTWCCCCCWCWCCCCCCWWW
WWWCWWCWWCWWCWCWWCWWWCWWW
WWWCCCCWWCWWCWCWWTWCCCWWW
WWWCWWCCWCWWCCCWWWWCWWWWW
WWWCWWWCCMWWWWCCWCCCWCWWW
WWWCWTWWWCWWWWWCWWWCWCWWW
WWWCCCCWCCCWCCCCCCCCCCWWW
WWWCWCWWWWCWCWWWWCWWWCWWW
WWWCWCCCWWCCCCCCWCCCCCWWW
WWWCWWWCCWWWWWWCWWCWWCWWW
WWWCWWWWCWWWTWWCWWCWWCWWW
WWWECCCCCCCCCICCCCCCCCWWW
WWWWWWWWWWWWWWWWWWWWWWWWW
WWWWWWWWWWWWWWWWWWWWWWWWW
WWWWWWWWWWWWWWWWWWWWWWWWW
